akr.	PROPN
bdv.	ADJ
bdv.bev.aukšt.	ADJ
bdv.bev.aukšč.	ADJ
bdv.bev.nelygin.	ADJ
bdv.mot.dgs.G.aukšt.	ADJ
bdv.mot.dgs.G.aukšt.įvardž.	ADJ
bdv.mot.dgs.G.aukšč.	ADJ
bdv.mot.dgs.G.aukšč.įvardž.	ADJ
bdv.mot.dgs.G.nelygin.	ADJ
bdv.mot.dgs.G.nelygin.įvardž.	ADJ
bdv.mot.dgs.K.aukšt.	ADJ
bdv.mot.dgs.K.aukšt.įvardž.	ADJ
bdv.mot.dgs.K.aukšč.	ADJ
bdv.mot.dgs.K.aukšč.įvardž.	ADJ
bdv.mot.dgs.K.nelygin.	ADJ
bdv.mot.dgs.K.nelygin.įvardž.	ADJ
bdv.mot.dgs.N.aukšt.	ADJ
bdv.mot.dgs.N.aukšč.	ADJ
bdv.mot.dgs.N.aukšč.įvardž.	ADJ
bdv.mot.dgs.N.nelygin.	ADJ
bdv.mot.dgs.N.nelygin.įvardž.	ADJ
bdv.mot.dgs.V.aukšt.	ADJ
bdv.mot.dgs.V.aukšt.įvardž.	ADJ
bdv.mot.dgs.V.aukšč.	ADJ
bdv.mot.dgs.V.aukšč.įvardž.	ADJ
bdv.mot.dgs.V.nelygin.	ADJ
bdv.mot.dgs.V.nelygin.įvardž.	ADJ
bdv.mot.dgs.Vt.aukšt.	ADJ
bdv.mot.dgs.Vt.aukšt.įvardž.	ADJ
bdv.mot.dgs.Vt.aukšč.	ADJ
bdv.mot.dgs.Vt.nelygin.	ADJ
bdv.mot.dgs.Vt.nelygin.įvardž.	ADJ
bdv.mot.dgs.Įn.aukšt.	ADJ
bdv.mot.dgs.Įn.aukšč.	ADJ
bdv.mot.dgs.Įn.nelygin.	ADJ
bdv.mot.dgs.Įn.nelygin.įvardž.	ADJ
bdv.mot.dgs.Š.nelygin.įvardž.	ADJ
bdv.mot.vns.G.aukšt.	ADJ
bdv.mot.vns.G.aukšt.įvardž.	ADJ
bdv.mot.vns.G.aukšč.	ADJ
bdv.mot.vns.G.aukšč.įvardž.	ADJ
bdv.mot.vns.G.nelygin.	ADJ
bdv.mot.vns.G.nelygin.įvardž.	ADJ
bdv.mot.vns.Il.nelygin.	ADJ
bdv.mot.vns.K.aukšt.	ADJ
bdv.mot.vns.K.aukšt.įvardž.	ADJ
bdv.mot.vns.K.aukšč.	ADJ
bdv.mot.vns.K.aukšč.įvardž.	ADJ
bdv.mot.vns.K.nelygin.	ADJ
bdv.mot.vns.K.nelygin.įvardž.	ADJ
bdv.mot.vns.N.aukšt.	ADJ
bdv.mot.vns.N.aukšt.įvardž.	ADJ
bdv.mot.vns.N.aukšč.	ADJ
bdv.mot.vns.N.aukšč.įvardž.	ADJ
bdv.mot.vns.N.nelygin.	ADJ
bdv.mot.vns.N.nelygin.įvardž.	ADJ
bdv.mot.vns.V.aukšt.	ADJ
bdv.mot.vns.V.aukšt.įvardž.	ADJ
bdv.mot.vns.V.aukšč.	ADJ
bdv.mot.vns.V.aukšč.įvardž.	ADJ
bdv.mot.vns.V.nelygin.	ADJ
bdv.mot.vns.V.nelygin.įvardž.	ADJ
bdv.mot.vns.Vt.aukšt.	ADJ
bdv.mot.vns.Vt.aukšt.įvardž.	ADJ
bdv.mot.vns.Vt.aukšč.	ADJ
bdv.mot.vns.Vt.aukšč.įvardž.	ADJ
bdv.mot.vns.Vt.nelygin.	ADJ
bdv.mot.vns.Vt.nelygin.įvardž.	ADJ
bdv.mot.vns.Įn.aukšt.	ADJ
bdv.mot.vns.Įn.aukšt.įvardž.	ADJ
bdv.mot.vns.Įn.aukšč.	ADJ
bdv.mot.vns.Įn.aukšč.įvardž.	ADJ
bdv.mot.vns.Įn.nelygin.	ADJ
bdv.mot.vns.Įn.nelygin.įvardž.	ADJ
bdv.mot.vns.Š.nelygin.	ADJ
bdv.mot.vns.Š.nelygin.įvardž.	ADJ
bdv.nelygin.	ADJ
bdv.vyr.dgs.G.aukšt.	ADJ
bdv.vyr.dgs.G.aukšt.įvardž.	ADJ
bdv.vyr.dgs.G.aukšč.	ADJ
bdv.vyr.dgs.G.aukšč.įvardž.	ADJ
bdv.vyr.dgs.G.nelygin.	ADJ
bdv.vyr.dgs.G.nelygin.įvardž.	ADJ
bdv.vyr.dgs.K.aukšt.	ADJ
bdv.vyr.dgs.K.aukšt.įvardž.	ADJ
bdv.vyr.dgs.K.aukšč.	ADJ
bdv.vyr.dgs.K.aukšč.įvardž.	ADJ
bdv.vyr.dgs.K.nelygin.	ADJ
bdv.vyr.dgs.K.nelygin.įvardž.	ADJ
bdv.vyr.dgs.N.aukšt.	ADJ
bdv.vyr.dgs.N.aukšč.	ADJ
bdv.vyr.dgs.N.nelygin.	ADJ
bdv.vyr.dgs.N.nelygin.įvardž.	ADJ
bdv.vyr.dgs.V.aukšt.	ADJ
bdv.vyr.dgs.V.aukšt.įvardž.	ADJ
bdv.vyr.dgs.V.aukšč.	ADJ
bdv.vyr.dgs.V.aukšč.įvardž.	ADJ
bdv.vyr.dgs.V.nelygin.	ADJ
bdv.vyr.dgs.V.nelygin.įvardž.	ADJ
bdv.vyr.dgs.Vt.aukšt.	ADJ
bdv.vyr.dgs.Vt.aukšč.	ADJ
bdv.vyr.dgs.Vt.nelygin.	ADJ
bdv.vyr.dgs.Vt.nelygin.įvardž.	ADJ
bdv.vyr.dgs.Įn.aukšt.	ADJ
bdv.vyr.dgs.Įn.aukšt.įvardž.	ADJ
bdv.vyr.dgs.Įn.aukšč.	ADJ
bdv.vyr.dgs.Įn.nelygin.	ADJ
bdv.vyr.dgs.Įn.nelygin.įvardž.	ADJ
bdv.vyr.dgs.Š.nelygin.	ADJ
bdv.vyr.dgs.Š.nelygin.įvardž.	ADJ
bdv.vyr.dvisk.G.nelygin.	ADJ
bdv.vyr.dvisk.V.nelygin.	ADJ
bdv.vyr.vns.G.aukšt.	ADJ
bdv.vyr.vns.G.aukšt.įvardž.	ADJ
bdv.vyr.vns.G.aukšč.	ADJ
bdv.vyr.vns.G.aukšč.įvardž.	ADJ
bdv.vyr.vns.G.nelygin.	ADJ
bdv.vyr.vns.G.nelygin.įvardž.	ADJ
bdv.vyr.vns.Il.nelygin.	ADJ
bdv.vyr.vns.K.aukšt.	ADJ
bdv.vyr.vns.K.aukšt.įvardž.	ADJ
bdv.vyr.vns.K.aukšč.	ADJ
bdv.vyr.vns.K.aukšč.įvardž.	ADJ
bdv.vyr.vns.K.nelygin.	ADJ
bdv.vyr.vns.K.nelygin.įvardž.	ADJ
bdv.vyr.vns.K.~DEM.	ADJ
bdv.vyr.vns.N.aukšt.	ADJ
bdv.vyr.vns.N.aukšt.įvardž.	ADJ
bdv.vyr.vns.N.aukšč.	ADJ
bdv.vyr.vns.N.aukšč.įvardž.	ADJ
bdv.vyr.vns.N.nelygin.	ADJ
bdv.vyr.vns.N.nelygin.įvardž.	ADJ
bdv.vyr.vns.V.aukšt.	ADJ
bdv.vyr.vns.V.aukšt.įvardž.	ADJ
bdv.vyr.vns.V.aukšč.	ADJ
bdv.vyr.vns.V.aukšč.įvardž.	ADJ
bdv.vyr.vns.V.nelygin.	ADJ
bdv.vyr.vns.V.nelygin.įvardž.	ADJ
bdv.vyr.vns.V.~DEM.	ADJ
bdv.vyr.vns.Vt.aukšt.	ADJ
bdv.vyr.vns.Vt.aukšč.	ADJ
bdv.vyr.vns.Vt.aukšč.įvardž.	ADJ
bdv.vyr.vns.Vt.nelygin.	ADJ
bdv.vyr.vns.Vt.nelygin.įvardž.	ADJ
bdv.vyr.vns.Įn.aukšt.	ADJ
bdv.vyr.vns.Įn.aukšt.įvardž.	ADJ
bdv.vyr.vns.Įn.aukšč.	ADJ
bdv.vyr.vns.Įn.aukšč.įvardž.	ADJ
bdv.vyr.vns.Įn.nelygin.	ADJ
bdv.vyr.vns.Įn.nelygin.įvardž.	ADJ
bdv.vyr.vns.Š.aukšč.	ADJ
bdv.vyr.vns.Š.aukšč.įvardž.	ADJ
bdv.vyr.vns.Š.nelygin.	ADJ
bdv.vyr.vns.Š.nelygin.įvardž.	ADJ
dkt.	NOUN
dkt.bendr.	NOUN
dkt.bendr.dgs.G.	NOUN
dkt.bendr.dgs.K.	NOUN
dkt.bendr.dgs.N.	NOUN
dkt.bendr.dgs.V.	NOUN
dkt.bendr.dgs.Įn.	NOUN
dkt.bendr.dgs.Š.	NOUN
dkt.bendr.vns.G.	NOUN
dkt.bendr.vns.K.	NOUN
dkt.bendr.vns.N.	NOUN
dkt.bendr.vns.V.	NOUN
dkt.bendr.vns.Įn.	NOUN
dkt.bendr.vns.Š.	NOUN
dkt.mot.	NOUN
dkt.mot.dgs.G.	NOUN
dkt.mot.dgs.K.	NOUN
dkt.mot.dgs.N.	NOUN
dkt.mot.dgs.V.	NOUN
dkt.mot.dgs.Vt.	NOUN
dkt.mot.dgs.Įn.	NOUN
dkt.mot.dgs.Š.	NOUN
dkt.mot.vns.G.	NOUN
dkt.mot.vns.Il.	NOUN
dkt.mot.vns.K.	NOUN
dkt.mot.vns.N.	NOUN
dkt.mot.vns.V.	NOUN
dkt.mot.vns.Vt.	NOUN
dkt.mot.vns.Įn.	NOUN
dkt.mot.vns.Š.	NOUN
dkt.tikr.	PROPN
dkt.tikr.bev.	PROPN
dkt.tikr.mot.	PROPN
dkt.tikr.mot.dgs.G.	PROPN
dkt.tikr.mot.dgs.K.	PROPN
dkt.tikr.mot.dgs.N.	PROPN
dkt.tikr.mot.dgs.V.	PROPN
dkt.tikr.mot.dgs.Vt.	PROPN
dkt.tikr.mot.dgs.Įn.	PROPN
dkt.tikr.mot.vns.G.	PROPN
dkt.tikr.mot.vns.Il.	PROPN
dkt.tikr.mot.vns.K.	PROPN
dkt.tikr.mot.vns.N.	PROPN
dkt.tikr.mot.vns.V.	PROPN
dkt.tikr.mot.vns.Vt.	PROPN
dkt.tikr.mot.vns.Įn.	PROPN
dkt.tikr.mot.vns.Š.	PROPN
dkt.tikr.vyr.	PROPN
dkt.tikr.vyr.dgs.G.	PROPN
dkt.tikr.vyr.dgs.K.	PROPN
dkt.tikr.vyr.dgs.N.	PROPN
dkt.tikr.vyr.dgs.V.	PROPN
dkt.tikr.vyr.dgs.Vt.	PROPN
dkt.tikr.vyr.dgs.Įn.	PROPN
dkt.tikr.vyr.dgs.Š.	PROPN
dkt.tikr.vyr.vns.G.	PROPN
dkt.tikr.vyr.vns.Il.	PROPN
dkt.tikr.vyr.vns.K.	PROPN
dkt.tikr.vyr.vns.N.	PROPN
dkt.tikr.vyr.vns.V.	PROPN
dkt.tikr.vyr.vns.Vt.	PROPN
dkt.tikr.vyr.vns.Įn.	PROPN
dkt.tikr.vyr.vns.Š.	PROPN
dkt.vyr.	NOUN
dkt.vyr.dgs.G.	NOUN
dkt.vyr.dgs.G.sngr.	NOUN
dkt.vyr.dgs.Il.	NOUN
dkt.vyr.dgs.K.	NOUN
dkt.vyr.dgs.K.sngr.	NOUN
dkt.vyr.dgs.N.	NOUN
dkt.vyr.dgs.N.sngr.	NOUN
dkt.vyr.dgs.V.	NOUN
dkt.vyr.dgs.V.sngr.	NOUN
dkt.vyr.dgs.Vt.	NOUN
dkt.vyr.dgs.Vt.sngr.	NOUN
dkt.vyr.dgs.Įn.	NOUN
dkt.vyr.dgs.Įn.sngr.	NOUN
dkt.vyr.dgs.Š.	NOUN
dkt.vyr.dvisk.V.	NOUN
dkt.vyr.vns.G.	NOUN
dkt.vyr.vns.G.sngr.	NOUN
dkt.vyr.vns.Il.	NOUN
dkt.vyr.vns.K.	NOUN
dkt.vyr.vns.K.sngr.	NOUN
dkt.vyr.vns.N.	NOUN
dkt.vyr.vns.N.sngr.	NOUN
dkt.vyr.vns.V.	NOUN
dkt.vyr.vns.V.sngr.	NOUN
dkt.vyr.vns.Vt.	NOUN
dkt.vyr.vns.Vt.sngr.	NOUN
dkt.vyr.vns.Įn.	NOUN
dkt.vyr.vns.Įn.sngr.	NOUN
dkt.vyr.vns.Š.	NOUN
dll.	PART
išt.	INTJ
jng.	CONJ
jst.	INTJ
kita.	X
prl.	ADP
prl.G.	ADP
prl.K.	ADP
prl.N.	ADP
prl.Įn.	ADP
prv.aukšt.	ADV
prv.aukšč.	ADV
prv.nelygin.	ADV
prv.~DEM.	ADV
sktv.	NUM
sktv.daugin.mot.G.	NUM
sktv.daugin.mot.K.	NUM
sktv.daugin.mot.V.	NUM
sktv.daugin.mot.Vt.	NUM
sktv.daugin.mot.dgs.Įn.	NUM
sktv.daugin.mot.Įn.	NUM
sktv.daugin.vyr.G.	NUM
sktv.daugin.vyr.K.	NUM
sktv.daugin.vyr.N.	NUM
sktv.daugin.vyr.V.	NUM
sktv.daugin.vyr.Įn.	NUM
sktv.kelint.bev.	ADJ
sktv.kelint.mot.Il.	ADJ
sktv.kelint.mot.dgs.G.	ADJ
sktv.kelint.mot.dgs.G.įvardž.	ADJ
sktv.kelint.mot.dgs.K.	ADJ
sktv.kelint.mot.dgs.K.įvardž.	ADJ
sktv.kelint.mot.dgs.N.	ADJ
sktv.kelint.mot.dgs.N.įvardž.	ADJ
sktv.kelint.mot.dgs.V.	ADJ
sktv.kelint.mot.dgs.V.įvardž.	ADJ
sktv.kelint.mot.dgs.Vt.	ADJ
sktv.kelint.mot.dgs.Vt.įvardž.	ADJ
sktv.kelint.mot.dgs.Įn.	ADJ
sktv.kelint.mot.dgs.Įn.įvardž.	ADJ
sktv.kelint.mot.vns.G.	ADJ
sktv.kelint.mot.vns.G.įvardž.	ADJ
sktv.kelint.mot.vns.K.	ADJ
sktv.kelint.mot.vns.K.įvardž.	ADJ
sktv.kelint.mot.vns.N.	ADJ
sktv.kelint.mot.vns.N.įvardž.	ADJ
sktv.kelint.mot.vns.V.	ADJ
sktv.kelint.mot.vns.V.įvardž.	ADJ
sktv.kelint.mot.vns.Vt.	ADJ
sktv.kelint.mot.vns.Vt.įvardž.	ADJ
sktv.kelint.mot.vns.Įn.	ADJ
sktv.kelint.mot.vns.Įn.įvardž.	ADJ
sktv.kelint.vyr.dgs.G.	ADJ
sktv.kelint.vyr.dgs.G.įvardž.	ADJ
sktv.kelint.vyr.dgs.K.	ADJ
sktv.kelint.vyr.dgs.K.įvardž.	ADJ
sktv.kelint.vyr.dgs.N.	ADJ
sktv.kelint.vyr.dgs.N.įvardž.	ADJ
sktv.kelint.vyr.dgs.V.	ADJ
sktv.kelint.vyr.dgs.V.įvardž.	ADJ
sktv.kelint.vyr.dgs.Vt.	ADJ
sktv.kelint.vyr.dgs.Vt.įvardž.	ADJ
sktv.kelint.vyr.dgs.Įn.	ADJ
sktv.kelint.vyr.dgs.Įn.įvardž.	ADJ
sktv.kelint.vyr.vns.G.	ADJ
sktv.kelint.vyr.vns.G.įvardž.	ADJ
sktv.kelint.vyr.vns.K.	ADJ
sktv.kelint.vyr.vns.K.įvardž.	ADJ
sktv.kelint.vyr.vns.N.	ADJ
sktv.kelint.vyr.vns.N.įvardž.	ADJ
sktv.kelint.vyr.vns.V.	ADJ
sktv.kelint.vyr.vns.V.įvardž.	ADJ
sktv.kelint.vyr.vns.Vt.	ADJ
sktv.kelint.vyr.vns.Vt.įvardž.	ADJ
sktv.kelint.vyr.vns.Įn.	ADJ
sktv.kelint.vyr.vns.Įn.įvardž.	ADJ
sktv.kiek.	NUM
sktv.kiek.G.	NUM
sktv.kiek.K.	NUM
sktv.kiek.N.	NUM
sktv.kiek.V.	NUM
sktv.kiek.Vt.	NUM
sktv.kiek.bev.	NUM
sktv.kiek.mot.G.	NUM
sktv.kiek.mot.K.	NUM
sktv.kiek.mot.N.	NUM
sktv.kiek.mot.V.	NUM
sktv.kiek.mot.Vt.	NUM
sktv.kiek.mot.dgs.G.	NUM
sktv.kiek.mot.dgs.K.	NUM
sktv.kiek.mot.dgs.N.	NUM
sktv.kiek.mot.dgs.V.	NUM
sktv.kiek.mot.dgs.Vt.	NUM
sktv.kiek.mot.dgs.Įn.	NUM
sktv.kiek.mot.vns.G.	NUM
sktv.kiek.mot.vns.K.	NUM
sktv.kiek.mot.vns.N.	NUM
sktv.kiek.mot.vns.V.	NUM
sktv.kiek.mot.vns.Vt.	NUM
sktv.kiek.mot.vns.Įn.	NUM
sktv.kiek.mot.Įn.	NUM
sktv.kiek.vyr.G.	NUM
sktv.kiek.vyr.K.	NUM
sktv.kiek.vyr.N.	NUM
sktv.kiek.vyr.V.	NUM
sktv.kiek.vyr.Vt.	NUM
sktv.kiek.vyr.dgs.G.	NUM
sktv.kiek.vyr.dgs.K.	NUM
sktv.kiek.vyr.dgs.N.	NUM
sktv.kiek.vyr.dgs.V.	NUM
sktv.kiek.vyr.dgs.Vt.	NUM
sktv.kiek.vyr.dgs.Įn.	NUM
sktv.kiek.vyr.vns.G.	NUM
sktv.kiek.vyr.vns.K.	NUM
sktv.kiek.vyr.vns.N.	NUM
sktv.kiek.vyr.vns.V.	NUM
sktv.kiek.vyr.vns.Vt.	NUM
sktv.kiek.vyr.vns.Įn.	NUM
sktv.kiek.vyr.Įn.	NUM
sktv.kiek.Įn.	NUM
sktv.kuopin.G.	NOUN
sktv.kuopin.K.	NOUN
sktv.kuopin.V.	NOUN
skyr.	PUNCT
sutr.	X
užs.	X
vksm	VERB
vksm.asm.1.dgs.liep.	VERB
vksm.asm.1.dgs.liep.neig.	VERB
vksm.asm.1.dgs.liep.neig.sngr.	VERB
vksm.asm.1.dgs.liep.sngr.	VERB
vksm.asm.1.dgs.tar.	VERB
vksm.asm.1.dgs.tar.neig.	VERB
vksm.asm.1.dgs.tar.neig.sngr.	VERB
vksm.asm.1.dgs.tar.sngr.	VERB
vksm.asm.1.vns.tar.	VERB
vksm.asm.1.vns.tar.neig.	VERB
vksm.asm.1.vns.tar.neig.sngr.	VERB
vksm.asm.1.vns.tar.sngr.	VERB
vksm.asm.2.dgs.liep.	VERB
vksm.asm.2.dgs.liep.neig.	VERB
vksm.asm.2.dgs.liep.neig.sngr.	VERB
vksm.asm.2.dgs.liep.sngr.	VERB
vksm.asm.2.dgs.tar.	VERB
vksm.asm.2.dgs.tar.neig.	VERB
vksm.asm.2.dgs.tar.sngr.	VERB
vksm.asm.2.vns.liep.	VERB
vksm.asm.2.vns.liep.neig.	VERB
vksm.asm.2.vns.liep.neig.sngr.	VERB
vksm.asm.2.vns.liep.sngr.	VERB
vksm.asm.2.vns.tar.	VERB
vksm.asm.2.vns.tar.neig.	VERB
vksm.asm.2.vns.tar.neig.sngr.	VERB
vksm.asm.2.vns.tar.sngr.	VERB
vksm.asm.3.liep.	VERB
vksm.asm.3.liep.sngr.	VERB
vksm.asm.3.tar.	VERB
vksm.asm.3.tar.neig.	VERB
vksm.asm.3.tar.neig.sngr.	VERB
vksm.asm.3.tar.sngr.	VERB
vksm.asm.būs.1.dgs.tar.	VERB
vksm.asm.būs.1.dgs.tiesiog.	VERB
vksm.asm.būs.1.dgs.tiesiog.neig.	VERB
vksm.asm.būs.1.dgs.tiesiog.neig.sngr.	VERB
vksm.asm.būs.1.dgs.tiesiog.sngr.	VERB
vksm.asm.būs.1.vns.tiesiog.	VERB
vksm.asm.būs.1.vns.tiesiog.neig.	VERB
vksm.asm.būs.1.vns.tiesiog.neig.sngr.	VERB
vksm.asm.būs.1.vns.tiesiog.sngr.	VERB
vksm.asm.būs.2.dgs.tiesiog.	VERB
vksm.asm.būs.2.dgs.tiesiog.neig.	VERB
vksm.asm.būs.2.dgs.tiesiog.neig.sngr.	VERB
vksm.asm.būs.2.dgs.tiesiog.sngr.	VERB
vksm.asm.būs.2.vns.tiesiog.	VERB
vksm.asm.būs.2.vns.tiesiog.neig.	VERB
vksm.asm.būs.2.vns.tiesiog.neig.sngr.	VERB
vksm.asm.būs.2.vns.tiesiog.sngr.	VERB
vksm.asm.būs.3.tiesiog.	VERB
vksm.asm.būs.3.tiesiog.neig.	VERB
vksm.asm.būs.3.tiesiog.neig.sngr.	VERB
vksm.asm.būs.3.tiesiog.sngr.	VERB
vksm.asm.būt-d.1.dgs.tiesiog.	VERB
vksm.asm.būt-d.1.dgs.tiesiog.neig.	VERB
vksm.asm.būt-d.1.dgs.tiesiog.neig.sngr.	VERB
vksm.asm.būt-d.1.dgs.tiesiog.sngr.	VERB
vksm.asm.būt-d.1.vns.tiesiog.	VERB
vksm.asm.būt-d.1.vns.tiesiog.neig.	VERB
vksm.asm.būt-d.1.vns.tiesiog.neig.sngr.	VERB
vksm.asm.būt-d.1.vns.tiesiog.sngr.	VERB
vksm.asm.būt-d.2.dgs.tiesiog.	VERB
vksm.asm.būt-d.2.dgs.tiesiog.neig.	VERB
vksm.asm.būt-d.2.dgs.tiesiog.neig.sngr.	VERB
vksm.asm.būt-d.2.dgs.tiesiog.sngr.	VERB
vksm.asm.būt-d.2.vns.tiesiog.	VERB
vksm.asm.būt-d.2.vns.tiesiog.neig.	VERB
vksm.asm.būt-d.2.vns.tiesiog.sngr.	VERB
vksm.asm.būt-d.3.tiesiog.	VERB
vksm.asm.būt-d.3.tiesiog.neig.	VERB
vksm.asm.būt-d.3.tiesiog.neig.sngr.	VERB
vksm.asm.būt-d.3.tiesiog.sngr.	VERB
vksm.asm.būt-k.1.dgs.tiesiog.	VERB
vksm.asm.būt-k.1.dgs.tiesiog.neig.	VERB
vksm.asm.būt-k.1.dgs.tiesiog.neig.sngr.	VERB
vksm.asm.būt-k.1.dgs.tiesiog.sngr.	VERB
vksm.asm.būt-k.1.vns.tar.neig.	VERB
vksm.asm.būt-k.1.vns.tar.sngr.	VERB
vksm.asm.būt-k.1.vns.tiesiog.	VERB
vksm.asm.būt-k.1.vns.tiesiog.neig.	VERB
vksm.asm.būt-k.1.vns.tiesiog.neig.sngr.	VERB
vksm.asm.būt-k.1.vns.tiesiog.sngr.	VERB
vksm.asm.būt-k.2.dgs.tiesiog.	VERB
vksm.asm.būt-k.2.dgs.tiesiog.neig.	VERB
vksm.asm.būt-k.2.dgs.tiesiog.neig.sngr.	VERB
vksm.asm.būt-k.2.dgs.tiesiog.sngr.	VERB
vksm.asm.būt-k.2.vns.tiesiog.	VERB
vksm.asm.būt-k.2.vns.tiesiog.neig.	VERB
vksm.asm.būt-k.2.vns.tiesiog.neig.sngr.	VERB
vksm.asm.būt-k.2.vns.tiesiog.sngr.	VERB
vksm.asm.būt-k.3.tiesiog.	VERB
vksm.asm.būt-k.3.tiesiog.neig.	VERB
vksm.asm.būt-k.3.tiesiog.neig.sngr.	VERB
vksm.asm.būt-k.3.tiesiog.sngr.	VERB
vksm.asm.būt.3.tiesiog.	VERB
vksm.asm.es.1.dgs.liep.	VERB
vksm.asm.es.1.dgs.tiesiog.	VERB
vksm.asm.es.1.dgs.tiesiog.neig.	VERB
vksm.asm.es.1.dgs.tiesiog.neig.sngr.	VERB
vksm.asm.es.1.dgs.tiesiog.sngr.	VERB
vksm.asm.es.1.vns.tiesiog.	VERB
vksm.asm.es.1.vns.tiesiog.neig.	VERB
vksm.asm.es.1.vns.tiesiog.neig.sngr.	VERB
vksm.asm.es.1.vns.tiesiog.sngr.	VERB
vksm.asm.es.2.dgs.tiesiog.	VERB
vksm.asm.es.2.dgs.tiesiog.neig.	VERB
vksm.asm.es.2.dgs.tiesiog.neig.sngr.	VERB
vksm.asm.es.2.dgs.tiesiog.sngr.	VERB
vksm.asm.es.2.tiesiog.	VERB
vksm.asm.es.2.vns.tiesiog.	VERB
vksm.asm.es.2.vns.tiesiog.neig.	VERB
vksm.asm.es.2.vns.tiesiog.neig.sngr.	VERB
vksm.asm.es.2.vns.tiesiog.sngr.	VERB
vksm.asm.es.3.	VERB
vksm.asm.es.3.tar.	VERB
vksm.asm.es.3.tiesiog.	VERB
vksm.asm.es.3.tiesiog.neig.	VERB
vksm.asm.es.3.tiesiog.neig.sngr.	VERB
vksm.asm.es.3.tiesiog.sngr.	VERB
vksm.bndr.	VERB
vksm.bndr.neig.	VERB
vksm.bndr.neig.sngr.	VERB
vksm.bndr.sngr.	VERB
vksm.dlv.bev.reik.	ADJ
vksm.dlv.bev.reik.neig.	ADJ
vksm.dlv.bev.reik.neig.sngr.	ADJ
vksm.dlv.bev.reik.sngr.	ADJ
vksm.dlv.būs.bev.veik.	VERB
vksm.dlv.būs.dgs.mot.neveik.G.	VERB
vksm.dlv.būs.dgs.mot.neveik.K.	VERB
vksm.dlv.būs.dgs.mot.neveik.N.	VERB
vksm.dlv.būs.dgs.mot.neveik.V.	VERB
vksm.dlv.būs.dgs.mot.neveik.Įn.	VERB
vksm.dlv.būs.dgs.mot.veik.G.	VERB
vksm.dlv.būs.dgs.mot.veik.K.	VERB
vksm.dlv.būs.dgs.mot.veik.V.	VERB
vksm.dlv.būs.dgs.vyr.neveik.G.	VERB
vksm.dlv.būs.dgs.vyr.neveik.K.	VERB
vksm.dlv.būs.dgs.vyr.neveik.N.	VERB
vksm.dlv.būs.dgs.vyr.neveik.V.	VERB
vksm.dlv.būs.dgs.vyr.neveik.Vt.	VERB
vksm.dlv.būs.dgs.vyr.neveik.Įn.	VERB
vksm.dlv.būs.dgs.vyr.veik.G.	VERB
vksm.dlv.būs.dgs.vyr.veik.K.	VERB
vksm.dlv.būs.dgs.vyr.veik.K.sngr.	VERB
vksm.dlv.būs.dgs.vyr.veik.V.	VERB
vksm.dlv.būs.dgs.vyr.veik.V.sngr.	VERB
vksm.dlv.būs.dgs.vyr.veik.Vt.	VERB
vksm.dlv.būs.dgs.vyr.veik.neig.K.	VERB
vksm.dlv.būs.dgs.vyr.veik.Įn.	VERB
vksm.dlv.būs.vns.mot.neveik.G.	VERB
vksm.dlv.būs.vns.mot.neveik.K.	VERB
vksm.dlv.būs.vns.mot.neveik.N.	VERB
vksm.dlv.būs.vns.mot.neveik.V.	VERB
vksm.dlv.būs.vns.mot.neveik.Vt.	VERB
vksm.dlv.būs.vns.mot.neveik.Įn.	VERB
vksm.dlv.būs.vns.mot.veik.G.	VERB
vksm.dlv.būs.vns.mot.veik.G.sngr.	VERB
vksm.dlv.būs.vns.mot.veik.K.	VERB
vksm.dlv.būs.vns.mot.veik.K.sngr.	VERB
vksm.dlv.būs.vns.mot.veik.N.	VERB
vksm.dlv.būs.vns.mot.veik.N.sngr.	VERB
vksm.dlv.būs.vns.mot.veik.V.	VERB
vksm.dlv.būs.vns.mot.veik.V.sngr.	VERB
vksm.dlv.būs.vns.mot.veik.Vt.sngr.	VERB
vksm.dlv.būs.vns.mot.veik.neig.V.	VERB
vksm.dlv.būs.vns.mot.veik.Įn.	VERB
vksm.dlv.būs.vns.vyr.neveik.G.	VERB
vksm.dlv.būs.vns.vyr.neveik.K.	VERB
vksm.dlv.būs.vns.vyr.neveik.N.	VERB
vksm.dlv.būs.vns.vyr.neveik.V.	VERB
vksm.dlv.būs.vns.vyr.neveik.Įn.	VERB
vksm.dlv.būs.vns.vyr.veik.G.	VERB
vksm.dlv.būs.vns.vyr.veik.G.sngr.	VERB
vksm.dlv.būs.vns.vyr.veik.K.	VERB
vksm.dlv.būs.vns.vyr.veik.K.sngr.	VERB
vksm.dlv.būs.vns.vyr.veik.N.	VERB
vksm.dlv.būs.vns.vyr.veik.V.	VERB
vksm.dlv.būs.vns.vyr.veik.V.sngr.	VERB
vksm.dlv.būs.vns.vyr.veik.Vt.	VERB
vksm.dlv.būs.vns.vyr.veik.Vt.sngr.	VERB
vksm.dlv.būs.vns.vyr.veik.neig.V.	VERB
vksm.dlv.būt-d.bev.veik.	VERB
vksm.dlv.būt-d.bev.veik.neig.	VERB
vksm.dlv.būt-d.dgs.mot.veik.V.	VERB
vksm.dlv.būt-d.dgs.vyr.veik.V.	VERB
vksm.dlv.būt-d.dgs.vyr.veik.V.sngr.	VERB
vksm.dlv.būt-d.dgs.vyr.veik.Įn.	VERB
vksm.dlv.būt-d.vns.mot.veik.G.	VERB
vksm.dlv.būt-d.vns.mot.veik.G.sngr.	VERB
vksm.dlv.būt-d.vns.mot.veik.K.	VERB
vksm.dlv.būt-d.vns.mot.veik.V.	VERB
vksm.dlv.būt-d.vns.vyr.veik.K.	VERB
vksm.dlv.būt-d.vns.vyr.veik.V.	VERB
vksm.dlv.būt-d.vns.vyr.veik.V.sngr.	VERB
vksm.dlv.būt-d.vns.vyr.veik.Įn.	VERB
vksm.dlv.būt-k.bev.veik.	VERB
vksm.dlv.būt-k.bev.veik.neig.	VERB
vksm.dlv.būt-k.bev.veik.neig.sngr.	VERB
vksm.dlv.būt-k.bev.veik.sngr.	VERB
vksm.dlv.būt-k.dgs.mot.veik.G.	VERB
vksm.dlv.būt-k.dgs.mot.veik.G.sngr.	VERB
vksm.dlv.būt-k.dgs.mot.veik.K.	VERB
vksm.dlv.būt-k.dgs.mot.veik.K.sngr.	VERB
vksm.dlv.būt-k.dgs.mot.veik.N.	VERB
vksm.dlv.būt-k.dgs.mot.veik.N.sngr.	VERB
vksm.dlv.būt-k.dgs.mot.veik.V.	VERB
vksm.dlv.būt-k.dgs.mot.veik.V.sngr.	VERB
vksm.dlv.būt-k.dgs.mot.veik.Vt.	VERB
vksm.dlv.būt-k.dgs.mot.veik.Vt.sngr.	VERB
vksm.dlv.būt-k.dgs.mot.veik.neig.G.	VERB
vksm.dlv.būt-k.dgs.mot.veik.neig.K.	VERB
vksm.dlv.būt-k.dgs.mot.veik.neig.K.sngr.	VERB
vksm.dlv.būt-k.dgs.mot.veik.neig.N.sngr.	VERB
vksm.dlv.būt-k.dgs.mot.veik.neig.V.	VERB
vksm.dlv.būt-k.dgs.mot.veik.neig.V.sngr.	VERB
vksm.dlv.būt-k.dgs.mot.veik.neig.Įn.	VERB
vksm.dlv.būt-k.dgs.mot.veik.Įn.	VERB
vksm.dlv.būt-k.dgs.mot.veik.Įn.sngr.	VERB
vksm.dlv.būt-k.dgs.vyr.veik.G.	VERB
vksm.dlv.būt-k.dgs.vyr.veik.G.sngr.	VERB
vksm.dlv.būt-k.dgs.vyr.veik.K.	VERB
vksm.dlv.būt-k.dgs.vyr.veik.K.sngr.	VERB
vksm.dlv.būt-k.dgs.vyr.veik.N.	VERB
vksm.dlv.būt-k.dgs.vyr.veik.N.sngr.	VERB
vksm.dlv.būt-k.dgs.vyr.veik.V.	VERB
vksm.dlv.būt-k.dgs.vyr.veik.V.sngr.	VERB
vksm.dlv.būt-k.dgs.vyr.veik.Vt.	VERB
vksm.dlv.būt-k.dgs.vyr.veik.Vt.sngr.	VERB
vksm.dlv.būt-k.dgs.vyr.veik.neig.G.	VERB
vksm.dlv.būt-k.dgs.vyr.veik.neig.G.sngr.	VERB
vksm.dlv.būt-k.dgs.vyr.veik.neig.K.	VERB
vksm.dlv.būt-k.dgs.vyr.veik.neig.K.sngr.	VERB
vksm.dlv.būt-k.dgs.vyr.veik.neig.N.	VERB
vksm.dlv.būt-k.dgs.vyr.veik.neig.N.sngr.	VERB
vksm.dlv.būt-k.dgs.vyr.veik.neig.V.	VERB
vksm.dlv.būt-k.dgs.vyr.veik.neig.V.sngr.	VERB
vksm.dlv.būt-k.dgs.vyr.veik.neig.Įn.	VERB
vksm.dlv.būt-k.dgs.vyr.veik.neig.Įn.sngr.	VERB
vksm.dlv.būt-k.dgs.vyr.veik.Įn.	VERB
vksm.dlv.būt-k.dgs.vyr.veik.Įn.sngr.	VERB
vksm.dlv.būt-k.vns.mot.neveik.N.sngr.	VERB
vksm.dlv.būt-k.vns.mot.veik.G.	VERB
vksm.dlv.būt-k.vns.mot.veik.G.sngr.	VERB
vksm.dlv.būt-k.vns.mot.veik.K.	VERB
vksm.dlv.būt-k.vns.mot.veik.K.sngr.	VERB
vksm.dlv.būt-k.vns.mot.veik.N.	VERB
vksm.dlv.būt-k.vns.mot.veik.N.sngr.	VERB
vksm.dlv.būt-k.vns.mot.veik.V.	VERB
vksm.dlv.būt-k.vns.mot.veik.V.sngr.	VERB
vksm.dlv.būt-k.vns.mot.veik.Vt.	VERB
vksm.dlv.būt-k.vns.mot.veik.Vt.sngr.	VERB
vksm.dlv.būt-k.vns.mot.veik.neig.G.	VERB
vksm.dlv.būt-k.vns.mot.veik.neig.G.sngr.	VERB
vksm.dlv.būt-k.vns.mot.veik.neig.K.	VERB
vksm.dlv.būt-k.vns.mot.veik.neig.K.sngr.	VERB
vksm.dlv.būt-k.vns.mot.veik.neig.N.	VERB
vksm.dlv.būt-k.vns.mot.veik.neig.V.	VERB
vksm.dlv.būt-k.vns.mot.veik.neig.V.sngr.	VERB
vksm.dlv.būt-k.vns.mot.veik.neig.Įn.	VERB
vksm.dlv.būt-k.vns.mot.veik.Įn.	VERB
vksm.dlv.būt-k.vns.mot.veik.Įn.sngr.	VERB
vksm.dlv.būt-k.vns.vyr.veik.G.	VERB
vksm.dlv.būt-k.vns.vyr.veik.G.sngr.	VERB
vksm.dlv.būt-k.vns.vyr.veik.K.	VERB
vksm.dlv.būt-k.vns.vyr.veik.K.sngr.	VERB
vksm.dlv.būt-k.vns.vyr.veik.N.	VERB
vksm.dlv.būt-k.vns.vyr.veik.N.sngr.	VERB
vksm.dlv.būt-k.vns.vyr.veik.V.	VERB
vksm.dlv.būt-k.vns.vyr.veik.V.sngr.	VERB
vksm.dlv.būt-k.vns.vyr.veik.Vt.	VERB
vksm.dlv.būt-k.vns.vyr.veik.Vt.sngr.	VERB
vksm.dlv.būt-k.vns.vyr.veik.neig.G.	VERB
vksm.dlv.būt-k.vns.vyr.veik.neig.G.sngr.	VERB
vksm.dlv.būt-k.vns.vyr.veik.neig.K.	VERB
vksm.dlv.būt-k.vns.vyr.veik.neig.K.sngr.	VERB
vksm.dlv.būt-k.vns.vyr.veik.neig.N.	VERB
vksm.dlv.būt-k.vns.vyr.veik.neig.N.sngr.	VERB
vksm.dlv.būt-k.vns.vyr.veik.neig.V.	VERB
vksm.dlv.būt-k.vns.vyr.veik.neig.V.sngr.	VERB
vksm.dlv.būt-k.vns.vyr.veik.neig.Vt.	VERB
vksm.dlv.būt-k.vns.vyr.veik.neig.Įn.	VERB
vksm.dlv.būt-k.vns.vyr.veik.neig.Įn.sngr.	VERB
vksm.dlv.būt-k.vns.vyr.veik.Įn.	VERB
vksm.dlv.būt-k.vns.vyr.veik.Įn.sngr.	VERB
vksm.dlv.būt.bev.neveik.	VERB
vksm.dlv.būt.bev.neveik.neig.	VERB
vksm.dlv.būt.bev.neveik.neig.sngr.	VERB
vksm.dlv.būt.bev.neveik.sngr.	VERB
vksm.dlv.būt.dgs.mot.neveik.G.	VERB
vksm.dlv.būt.dgs.mot.neveik.G.sngr.	VERB
vksm.dlv.būt.dgs.mot.neveik.K.	VERB
vksm.dlv.būt.dgs.mot.neveik.K.sngr.	VERB
vksm.dlv.būt.dgs.mot.neveik.N.	VERB
vksm.dlv.būt.dgs.mot.neveik.V.	VERB
vksm.dlv.būt.dgs.mot.neveik.V.sngr.	VERB
vksm.dlv.būt.dgs.mot.neveik.Vt.	VERB
vksm.dlv.būt.dgs.mot.neveik.Vt.sngr.	VERB
vksm.dlv.būt.dgs.mot.neveik.neig.G.	VERB
vksm.dlv.būt.dgs.mot.neveik.neig.G.sngr.	VERB
vksm.dlv.būt.dgs.mot.neveik.neig.K.	VERB
vksm.dlv.būt.dgs.mot.neveik.neig.K.sngr.	VERB
vksm.dlv.būt.dgs.mot.neveik.neig.N.	VERB
vksm.dlv.būt.dgs.mot.neveik.neig.V.	VERB
vksm.dlv.būt.dgs.mot.neveik.neig.V.sngr.	VERB
vksm.dlv.būt.dgs.mot.neveik.neig.Vt.	VERB
vksm.dlv.būt.dgs.mot.neveik.neig.Įn.	VERB
vksm.dlv.būt.dgs.mot.neveik.Įn.	VERB
vksm.dlv.būt.dgs.mot.neveik.Įn.sngr.	VERB
vksm.dlv.būt.dgs.vyr.neveik.G.	VERB
vksm.dlv.būt.dgs.vyr.neveik.G.sngr.	VERB
vksm.dlv.būt.dgs.vyr.neveik.K.	VERB
vksm.dlv.būt.dgs.vyr.neveik.K.sngr.	VERB
vksm.dlv.būt.dgs.vyr.neveik.N.	VERB
vksm.dlv.būt.dgs.vyr.neveik.N.sngr.	VERB
vksm.dlv.būt.dgs.vyr.neveik.V.	VERB
vksm.dlv.būt.dgs.vyr.neveik.V.sngr.	VERB
vksm.dlv.būt.dgs.vyr.neveik.Vt.	VERB
vksm.dlv.būt.dgs.vyr.neveik.neig.G.	VERB
vksm.dlv.būt.dgs.vyr.neveik.neig.K.	VERB
vksm.dlv.būt.dgs.vyr.neveik.neig.K.sngr.	VERB
vksm.dlv.būt.dgs.vyr.neveik.neig.N.	VERB
vksm.dlv.būt.dgs.vyr.neveik.neig.V.	VERB
vksm.dlv.būt.dgs.vyr.neveik.neig.V.sngr.	VERB
vksm.dlv.būt.dgs.vyr.neveik.neig.Vt.	VERB
vksm.dlv.būt.dgs.vyr.neveik.neig.Įn.	VERB
vksm.dlv.būt.dgs.vyr.neveik.Įn.	VERB
vksm.dlv.būt.dgs.vyr.neveik.Įn.sngr.	VERB
vksm.dlv.būt.dgs.vyr.neveik.Š.	VERB
vksm.dlv.būt.dgs.vyr.veik.V.	VERB
vksm.dlv.būt.vns.mot.neveik.G.	VERB
vksm.dlv.būt.vns.mot.neveik.G.sngr.	VERB
vksm.dlv.būt.vns.mot.neveik.Il.	VERB
vksm.dlv.būt.vns.mot.neveik.K.	VERB
vksm.dlv.būt.vns.mot.neveik.K.sngr.	VERB
vksm.dlv.būt.vns.mot.neveik.N.	VERB
vksm.dlv.būt.vns.mot.neveik.N.sngr.	VERB
vksm.dlv.būt.vns.mot.neveik.V.	VERB
vksm.dlv.būt.vns.mot.neveik.V.sngr.	VERB
vksm.dlv.būt.vns.mot.neveik.Vt.	VERB
vksm.dlv.būt.vns.mot.neveik.Vt.sngr.	VERB
vksm.dlv.būt.vns.mot.neveik.neig.G.	VERB
vksm.dlv.būt.vns.mot.neveik.neig.G.sngr.	VERB
vksm.dlv.būt.vns.mot.neveik.neig.K.	VERB
vksm.dlv.būt.vns.mot.neveik.neig.K.sngr.	VERB
vksm.dlv.būt.vns.mot.neveik.neig.N.	VERB
vksm.dlv.būt.vns.mot.neveik.neig.V.	VERB
vksm.dlv.būt.vns.mot.neveik.neig.V.sngr.	VERB
vksm.dlv.būt.vns.mot.neveik.neig.Vt.	VERB
vksm.dlv.būt.vns.mot.neveik.neig.Įn.	VERB
vksm.dlv.būt.vns.mot.neveik.Įn.	VERB
vksm.dlv.būt.vns.mot.neveik.Įn.sngr.	VERB
vksm.dlv.būt.vns.mot.neveik.Š.	VERB
vksm.dlv.būt.vns.vyr.neveik.G.	VERB
vksm.dlv.būt.vns.vyr.neveik.G.sngr.	VERB
vksm.dlv.būt.vns.vyr.neveik.K.	VERB
vksm.dlv.būt.vns.vyr.neveik.K.sngr.	VERB
vksm.dlv.būt.vns.vyr.neveik.N.	VERB
vksm.dlv.būt.vns.vyr.neveik.N.sngr.	VERB
vksm.dlv.būt.vns.vyr.neveik.V.	VERB
vksm.dlv.būt.vns.vyr.neveik.V.sngr.	VERB
vksm.dlv.būt.vns.vyr.neveik.Vt.	VERB
vksm.dlv.būt.vns.vyr.neveik.Vt.sngr.	VERB
vksm.dlv.būt.vns.vyr.neveik.neig.G.	VERB
vksm.dlv.būt.vns.vyr.neveik.neig.G.sngr.	VERB
vksm.dlv.būt.vns.vyr.neveik.neig.K.	VERB
vksm.dlv.būt.vns.vyr.neveik.neig.N.	VERB
vksm.dlv.būt.vns.vyr.neveik.neig.V.	VERB
vksm.dlv.būt.vns.vyr.neveik.neig.V.sngr.	VERB
vksm.dlv.būt.vns.vyr.neveik.neig.Vt.	VERB
vksm.dlv.būt.vns.vyr.neveik.neig.Įn.	VERB
vksm.dlv.būt.vns.vyr.neveik.neig.Š.	VERB
vksm.dlv.būt.vns.vyr.neveik.Įn.	VERB
vksm.dlv.būt.vns.vyr.neveik.Įn.sngr.	VERB
vksm.dlv.būt.vns.vyr.neveik.Š.	VERB
vksm.dlv.būt.vns.vyr.veik.G.	VERB
vksm.dlv.dgs.mot.reik.G.	ADJ
vksm.dlv.dgs.mot.reik.K.	ADJ
vksm.dlv.dgs.mot.reik.K.sngr.	ADJ
vksm.dlv.dgs.mot.reik.N.	ADJ
vksm.dlv.dgs.mot.reik.V.	ADJ
vksm.dlv.dgs.mot.reik.Vt.	ADJ
vksm.dlv.dgs.mot.reik.neig.G.	ADJ
vksm.dlv.dgs.mot.reik.neig.K.	ADJ
vksm.dlv.dgs.mot.reik.neig.V.	ADJ
vksm.dlv.dgs.mot.reik.Įn.	ADJ
vksm.dlv.dgs.vyr.reik.G.	ADJ
vksm.dlv.dgs.vyr.reik.G.sngr.	ADJ
vksm.dlv.dgs.vyr.reik.K.	ADJ
vksm.dlv.dgs.vyr.reik.K.sngr.	ADJ
vksm.dlv.dgs.vyr.reik.N.	ADJ
vksm.dlv.dgs.vyr.reik.V.	ADJ
vksm.dlv.dgs.vyr.reik.V.sngr.	ADJ
vksm.dlv.dgs.vyr.reik.Vt.	ADJ
vksm.dlv.dgs.vyr.reik.neig.G.	ADJ
vksm.dlv.dgs.vyr.reik.neig.K.	ADJ
vksm.dlv.dgs.vyr.reik.neig.N.	ADJ
vksm.dlv.dgs.vyr.reik.neig.V.	ADJ
vksm.dlv.dgs.vyr.reik.neig.Įn.	ADJ
vksm.dlv.dgs.vyr.reik.Įn.	ADJ
vksm.dlv.es.bev.neveik.	VERB
vksm.dlv.es.bev.neveik.neig.	VERB
vksm.dlv.es.bev.neveik.neig.sngr.	VERB
vksm.dlv.es.bev.neveik.sngr.	VERB
vksm.dlv.es.bev.veik.	VERB
vksm.dlv.es.bev.veik.neig.	VERB
vksm.dlv.es.dgs.mot.neveik.G.	VERB
vksm.dlv.es.dgs.mot.neveik.G.sngr.	VERB
vksm.dlv.es.dgs.mot.neveik.K.	VERB
vksm.dlv.es.dgs.mot.neveik.K.sngr.	VERB
vksm.dlv.es.dgs.mot.neveik.N.	VERB
vksm.dlv.es.dgs.mot.neveik.N.sngr.	VERB
vksm.dlv.es.dgs.mot.neveik.V.	VERB
vksm.dlv.es.dgs.mot.neveik.V.sngr.	VERB
vksm.dlv.es.dgs.mot.neveik.Vt.	VERB
vksm.dlv.es.dgs.mot.neveik.Vt.sngr.	VERB
vksm.dlv.es.dgs.mot.neveik.neig.G.	VERB
vksm.dlv.es.dgs.mot.neveik.neig.K.	VERB
vksm.dlv.es.dgs.mot.neveik.neig.N.	VERB
vksm.dlv.es.dgs.mot.neveik.neig.V.	VERB
vksm.dlv.es.dgs.mot.neveik.neig.Vt.	VERB
vksm.dlv.es.dgs.mot.neveik.neig.Įn.	VERB
vksm.dlv.es.dgs.mot.neveik.Įn.	VERB
vksm.dlv.es.dgs.mot.neveik.Įn.sngr.	VERB
vksm.dlv.es.dgs.mot.veik.G.	VERB
vksm.dlv.es.dgs.mot.veik.G.sngr.	VERB
vksm.dlv.es.dgs.mot.veik.K.	VERB
vksm.dlv.es.dgs.mot.veik.K.sngr.	VERB
vksm.dlv.es.dgs.mot.veik.N.	VERB
vksm.dlv.es.dgs.mot.veik.N.sngr.	VERB
vksm.dlv.es.dgs.mot.veik.V.	VERB
vksm.dlv.es.dgs.mot.veik.V.sngr.	VERB
vksm.dlv.es.dgs.mot.veik.Vt.	VERB
vksm.dlv.es.dgs.mot.veik.Vt.sngr.	VERB
vksm.dlv.es.dgs.mot.veik.neig.G.	VERB
vksm.dlv.es.dgs.mot.veik.neig.G.sngr.	VERB
vksm.dlv.es.dgs.mot.veik.neig.K.	VERB
vksm.dlv.es.dgs.mot.veik.neig.K.sngr.	VERB
vksm.dlv.es.dgs.mot.veik.neig.N.	VERB
vksm.dlv.es.dgs.mot.veik.neig.N.sngr.	VERB
vksm.dlv.es.dgs.mot.veik.neig.V.	VERB
vksm.dlv.es.dgs.mot.veik.neig.V.sngr.	VERB
vksm.dlv.es.dgs.mot.veik.neig.Vt.	VERB
vksm.dlv.es.dgs.mot.veik.neig.Įn.	VERB
vksm.dlv.es.dgs.mot.veik.neig.Įn.sngr.	VERB
vksm.dlv.es.dgs.mot.veik.Įn.	VERB
vksm.dlv.es.dgs.mot.veik.Įn.sngr.	VERB
vksm.dlv.es.dgs.vyr.neveik.G.	VERB
vksm.dlv.es.dgs.vyr.neveik.G.sngr.	VERB
vksm.dlv.es.dgs.vyr.neveik.K.	VERB
vksm.dlv.es.dgs.vyr.neveik.K.sngr.	VERB
vksm.dlv.es.dgs.vyr.neveik.N.	VERB
vksm.dlv.es.dgs.vyr.neveik.N.sngr.	VERB
vksm.dlv.es.dgs.vyr.neveik.V.	VERB
vksm.dlv.es.dgs.vyr.neveik.V.sngr.	VERB
vksm.dlv.es.dgs.vyr.neveik.Vt.	VERB
vksm.dlv.es.dgs.vyr.neveik.Vt.sngr.	VERB
vksm.dlv.es.dgs.vyr.neveik.neig.G.	VERB
vksm.dlv.es.dgs.vyr.neveik.neig.K.	VERB
vksm.dlv.es.dgs.vyr.neveik.neig.N.	VERB
vksm.dlv.es.dgs.vyr.neveik.neig.V.	VERB
vksm.dlv.es.dgs.vyr.neveik.neig.Vt.	VERB
vksm.dlv.es.dgs.vyr.neveik.neig.Įn.	VERB
vksm.dlv.es.dgs.vyr.neveik.Įn.	VERB
vksm.dlv.es.dgs.vyr.neveik.Š.	VERB
vksm.dlv.es.dgs.vyr.veik.G.	VERB
vksm.dlv.es.dgs.vyr.veik.G.sngr.	VERB
vksm.dlv.es.dgs.vyr.veik.K.	VERB
vksm.dlv.es.dgs.vyr.veik.K.sngr.	VERB
vksm.dlv.es.dgs.vyr.veik.N.	VERB
vksm.dlv.es.dgs.vyr.veik.N.sngr.	VERB
vksm.dlv.es.dgs.vyr.veik.V.	VERB
vksm.dlv.es.dgs.vyr.veik.V.sngr.	VERB
vksm.dlv.es.dgs.vyr.veik.Vt.	VERB
vksm.dlv.es.dgs.vyr.veik.Vt.sngr.	VERB
vksm.dlv.es.dgs.vyr.veik.neig.G.	VERB
vksm.dlv.es.dgs.vyr.veik.neig.G.sngr.	VERB
vksm.dlv.es.dgs.vyr.veik.neig.K.	VERB
vksm.dlv.es.dgs.vyr.veik.neig.K.sngr.	VERB
vksm.dlv.es.dgs.vyr.veik.neig.N.	VERB
vksm.dlv.es.dgs.vyr.veik.neig.N.sngr.	VERB
vksm.dlv.es.dgs.vyr.veik.neig.V.	VERB
vksm.dlv.es.dgs.vyr.veik.neig.V.sngr.	VERB
vksm.dlv.es.dgs.vyr.veik.neig.Vt.	VERB
vksm.dlv.es.dgs.vyr.veik.neig.Įn.	VERB
vksm.dlv.es.dgs.vyr.veik.neig.Įn.sngr.	VERB
vksm.dlv.es.dgs.vyr.veik.Įn.	VERB
vksm.dlv.es.dgs.vyr.veik.Įn.sngr.	VERB
vksm.dlv.es.dvisk.vyr.neveik.G.	VERB
vksm.dlv.es.vns.mot.neveik.G.	VERB
vksm.dlv.es.vns.mot.neveik.G.sngr.	VERB
vksm.dlv.es.vns.mot.neveik.Il.	VERB
vksm.dlv.es.vns.mot.neveik.K.	VERB
vksm.dlv.es.vns.mot.neveik.K.sngr.	VERB
vksm.dlv.es.vns.mot.neveik.N.	VERB
vksm.dlv.es.vns.mot.neveik.N.sngr.	VERB
vksm.dlv.es.vns.mot.neveik.V.	VERB
vksm.dlv.es.vns.mot.neveik.V.sngr.	VERB
vksm.dlv.es.vns.mot.neveik.Vt.	VERB
vksm.dlv.es.vns.mot.neveik.Vt.sngr.	VERB
vksm.dlv.es.vns.mot.neveik.neig.G.	VERB
vksm.dlv.es.vns.mot.neveik.neig.K.	VERB
vksm.dlv.es.vns.mot.neveik.neig.N.	VERB
vksm.dlv.es.vns.mot.neveik.neig.V.	VERB
vksm.dlv.es.vns.mot.neveik.neig.V.sngr.	VERB
vksm.dlv.es.vns.mot.neveik.neig.Vt.	VERB
vksm.dlv.es.vns.mot.neveik.neig.Įn.	VERB
vksm.dlv.es.vns.mot.neveik.Įn.	VERB
vksm.dlv.es.vns.mot.neveik.Įn.sngr.	VERB
vksm.dlv.es.vns.mot.neveik.Š.	VERB
vksm.dlv.es.vns.mot.veik.G.	VERB
vksm.dlv.es.vns.mot.veik.G.sngr.	VERB
vksm.dlv.es.vns.mot.veik.K.	VERB
vksm.dlv.es.vns.mot.veik.K.sngr.	VERB
vksm.dlv.es.vns.mot.veik.N.	VERB
vksm.dlv.es.vns.mot.veik.N.sngr.	VERB
vksm.dlv.es.vns.mot.veik.V.	VERB
vksm.dlv.es.vns.mot.veik.V.sngr.	VERB
vksm.dlv.es.vns.mot.veik.Vt.	VERB
vksm.dlv.es.vns.mot.veik.Vt.sngr.	VERB
vksm.dlv.es.vns.mot.veik.neig.G.	VERB
vksm.dlv.es.vns.mot.veik.neig.G.sngr.	VERB
vksm.dlv.es.vns.mot.veik.neig.K.	VERB
vksm.dlv.es.vns.mot.veik.neig.K.sngr.	VERB
vksm.dlv.es.vns.mot.veik.neig.N.	VERB
vksm.dlv.es.vns.mot.veik.neig.N.sngr.	VERB
vksm.dlv.es.vns.mot.veik.neig.V.	VERB
vksm.dlv.es.vns.mot.veik.neig.V.sngr.	VERB
vksm.dlv.es.vns.mot.veik.neig.Vt.	VERB
vksm.dlv.es.vns.mot.veik.neig.Vt.sngr.	VERB
vksm.dlv.es.vns.mot.veik.neig.Įn.	VERB
vksm.dlv.es.vns.mot.veik.Įn.	VERB
vksm.dlv.es.vns.mot.veik.Įn.sngr.	VERB
vksm.dlv.es.vns.vyr.neveik.G.	VERB
vksm.dlv.es.vns.vyr.neveik.G.sngr.	VERB
vksm.dlv.es.vns.vyr.neveik.K.	VERB
vksm.dlv.es.vns.vyr.neveik.K.sngr.	VERB
vksm.dlv.es.vns.vyr.neveik.N.	VERB
vksm.dlv.es.vns.vyr.neveik.V.	VERB
vksm.dlv.es.vns.vyr.neveik.V.sngr.	VERB
vksm.dlv.es.vns.vyr.neveik.Vt.	VERB
vksm.dlv.es.vns.vyr.neveik.neig.G.	VERB
vksm.dlv.es.vns.vyr.neveik.neig.K.	VERB
vksm.dlv.es.vns.vyr.neveik.neig.K.sngr.	VERB
vksm.dlv.es.vns.vyr.neveik.neig.N.	VERB
vksm.dlv.es.vns.vyr.neveik.neig.V.	VERB
vksm.dlv.es.vns.vyr.neveik.neig.V.sngr.	VERB
vksm.dlv.es.vns.vyr.neveik.neig.Vt.	VERB
vksm.dlv.es.vns.vyr.neveik.neig.Įn.	VERB
vksm.dlv.es.vns.vyr.neveik.Įn.	VERB
vksm.dlv.es.vns.vyr.neveik.Įn.sngr.	VERB
vksm.dlv.es.vns.vyr.neveik.Š.	VERB
vksm.dlv.es.vns.vyr.veik.G.	VERB
vksm.dlv.es.vns.vyr.veik.G.sngr.	VERB
vksm.dlv.es.vns.vyr.veik.K.	VERB
vksm.dlv.es.vns.vyr.veik.K.sngr.	VERB
vksm.dlv.es.vns.vyr.veik.N.	VERB
vksm.dlv.es.vns.vyr.veik.N.sngr.	VERB
vksm.dlv.es.vns.vyr.veik.V.	VERB
vksm.dlv.es.vns.vyr.veik.V.sngr.	VERB
vksm.dlv.es.vns.vyr.veik.Vt.	VERB
vksm.dlv.es.vns.vyr.veik.Vt.sngr.	VERB
vksm.dlv.es.vns.vyr.veik.neig.G.	VERB
vksm.dlv.es.vns.vyr.veik.neig.G.sngr.	VERB
vksm.dlv.es.vns.vyr.veik.neig.K.	VERB
vksm.dlv.es.vns.vyr.veik.neig.K.sngr.	VERB
vksm.dlv.es.vns.vyr.veik.neig.N.	VERB
vksm.dlv.es.vns.vyr.veik.neig.N.sngr.	VERB
vksm.dlv.es.vns.vyr.veik.neig.V.	VERB
vksm.dlv.es.vns.vyr.veik.neig.V.sngr.	VERB
vksm.dlv.es.vns.vyr.veik.neig.Vt.	VERB
vksm.dlv.es.vns.vyr.veik.neig.Įn.	VERB
vksm.dlv.es.vns.vyr.veik.neig.Įn.sngr.	VERB
vksm.dlv.es.vns.vyr.veik.Įn.	VERB
vksm.dlv.es.vns.vyr.veik.Įn.sngr.	VERB
vksm.dlv.vns.mot.V.	VERB
vksm.dlv.vns.mot.neveik.K.	VERB
vksm.dlv.vns.mot.reik.G.	ADJ
vksm.dlv.vns.mot.reik.G.sngr.	ADJ
vksm.dlv.vns.mot.reik.K.	ADJ
vksm.dlv.vns.mot.reik.V.	ADJ
vksm.dlv.vns.mot.reik.V.sngr.	ADJ
vksm.dlv.vns.mot.reik.Vt.	ADJ
vksm.dlv.vns.mot.reik.neig.G.	ADJ
vksm.dlv.vns.mot.reik.neig.K.	ADJ
vksm.dlv.vns.mot.reik.neig.N.	ADJ
vksm.dlv.vns.mot.reik.neig.V.	ADJ
vksm.dlv.vns.mot.reik.neig.Įn.	ADJ
vksm.dlv.vns.mot.reik.Įn.	ADJ
vksm.dlv.vns.vyr.reik.G.	ADJ
vksm.dlv.vns.vyr.reik.K.	ADJ
vksm.dlv.vns.vyr.reik.N.	ADJ
vksm.dlv.vns.vyr.reik.V.	ADJ
vksm.dlv.vns.vyr.reik.V.sngr.	ADJ
vksm.dlv.vns.vyr.reik.Vt.	ADJ
vksm.dlv.vns.vyr.reik.neig.G.	ADJ
vksm.dlv.vns.vyr.reik.neig.V.	ADJ
vksm.dlv.vns.vyr.reik.neig.Įn.	ADJ
vksm.dlv.vns.vyr.reik.Įn.	ADJ
vksm.pad.būs.	VERB
vksm.pad.būt-k.	VERB
vksm.pad.būt-k.neig.	VERB
vksm.pad.būt-k.neig.sngr.	VERB
vksm.pad.būt-k.sngr.	VERB
vksm.pad.es.	VERB
vksm.pad.es.neig.	VERB
vksm.pad.es.neig.sngr.	VERB
vksm.pad.es.sngr.	VERB
vksm.pusd.dgs.mot.	VERB
vksm.pusd.dgs.mot.neig.	VERB
vksm.pusd.dgs.mot.neig.sngr.	VERB
vksm.pusd.dgs.mot.sngr.	VERB
vksm.pusd.dgs.vyr.	VERB
vksm.pusd.dgs.vyr.neig.	VERB
vksm.pusd.dgs.vyr.neig.sngr.	VERB
vksm.pusd.dgs.vyr.sngr.	VERB
vksm.pusd.vns.mot.	VERB
vksm.pusd.vns.mot.neig.	VERB
vksm.pusd.vns.mot.neig.sngr.	VERB
vksm.pusd.vns.mot.sngr.	VERB
vksm.pusd.vns.vyr.	VERB
vksm.pusd.vns.vyr.neig.	VERB
vksm.pusd.vns.vyr.neig.sngr.	VERB
vksm.pusd.vns.vyr.sngr.	VERB
įv.	PRON
įv.G.	PRON
įv.Il.	PRON
įv.K.	PRON
įv.N.	PRON
įv.V.	PRON
įv.Vt.	PRON
įv.bev.	PRON
įv.bev.vns.Įn.	PRON
įv.bev.įvardž.	PRON
įv.dgs.G.	PRON
įv.dgs.K.	PRON
įv.dgs.N.	PRON
įv.dgs.V.	PRON
įv.dgs.Vt.	PRON
įv.dgs.Įn.	PRON
įv.dvisk.V.	PRON
įv.mot.G.	PRON
įv.mot.K.	PRON
įv.mot.N.	PRON
įv.mot.V.	PRON
įv.mot.Vt.	PRON
įv.mot.dgs.G.	PRON
įv.mot.dgs.G.įvardž.	PRON
įv.mot.dgs.K.	PRON
įv.mot.dgs.K.įvardž.	PRON
įv.mot.dgs.N.	PRON
įv.mot.dgs.V.	PRON
įv.mot.dgs.V.įvardž.	PRON
įv.mot.dgs.Vt.	PRON
įv.mot.dgs.Įn.	PRON
įv.mot.dvisk.G.	PRON
įv.mot.dvisk.K.	PRON
įv.mot.dvisk.N.	PRON
įv.mot.dvisk.V.	PRON
įv.mot.dvisk.Vt.	PRON
įv.mot.dvisk.Įn.	PRON
įv.mot.vns.G.	PRON
įv.mot.vns.G.įvardž.	PRON
įv.mot.vns.Il.	PRON
įv.mot.vns.K.	PRON
įv.mot.vns.K.įvardž.	PRON
įv.mot.vns.N.	PRON
įv.mot.vns.N.įvardž.	PRON
įv.mot.vns.V.	PRON
įv.mot.vns.V.įvardž.	PRON
įv.mot.vns.Vt.	PRON
įv.mot.vns.Vt.įvardž.	PRON
įv.mot.vns.Įn.	PRON
įv.mot.vns.Įn.įvardž.	PRON
įv.mot.Įn.	PRON
įv.vns.	PRON
įv.vns.G.	PRON
įv.vns.K.	PRON
įv.vns.N.	PRON
įv.vns.V.	PRON
įv.vns.Vt.	PRON
įv.vns.Įn.	PRON
įv.vns.Š.	PRON
įv.vyr.G.	PRON
įv.vyr.K.	PRON
įv.vyr.N.	PRON
įv.vyr.V.	PRON
įv.vyr.Vt.	PRON
įv.vyr.dgs.G.	PRON
įv.vyr.dgs.G.įvardž.	PRON
įv.vyr.dgs.K.	PRON
įv.vyr.dgs.K.įvardž.	PRON
įv.vyr.dgs.N.	PRON
įv.vyr.dgs.N.įvardž.	PRON
įv.vyr.dgs.V.	PRON
įv.vyr.dgs.V.įvardž.	PRON
įv.vyr.dgs.Vt.	PRON
įv.vyr.dgs.Įn.	PRON
įv.vyr.dgs.Įn.įvardž.	PRON
įv.vyr.dgs.Š.	PRON
įv.vyr.dvisk.G.	PRON
įv.vyr.dvisk.K.	PRON
įv.vyr.dvisk.N.	PRON
įv.vyr.dvisk.V.	PRON
įv.vyr.dvisk.Vt.	PRON
įv.vyr.dvisk.Įn.	PRON
įv.vyr.vns.G.	PRON
įv.vyr.vns.G.įvardž.	PRON
įv.vyr.vns.Il.	PRON
įv.vyr.vns.K.	PRON
įv.vyr.vns.K.įvardž.	PRON
įv.vyr.vns.N.	PRON
įv.vyr.vns.N.įvardž.	PRON
įv.vyr.vns.V.	PRON
įv.vyr.vns.V.įvardž.	PRON
įv.vyr.vns.Vt.	PRON
įv.vyr.vns.Vt.įvardž.	PRON
įv.vyr.vns.Įn.	PRON
įv.vyr.vns.Įn.įvardž.	PRON
įv.vyr.Įn.	PRON
įv.Įn.	PRON